1111111111111111111111111111111111
1C10000000000000C00000000000000001
10100101001000001010C1001000010101
101001001011101000111100100001C101
1P00000000000010000000001000010001
1011111000010011000000001000011101
10000C100001000C000010000000000001
10E1001000111000001110000011101111
10010000000C100000010000001C000001
1111111111111111111111111111111111